1 1 1 1 1 1 1 1 1 1 1 1 1 
1 0 3 0 0 0 0 0 0 0 2 0 1 
1 0 0 0 0 0 7 0 0 2 2 0 1 
1 0 2 0 0 0 0 0 0 0 0 0 1 
1 0 0 0 0 0 0 0 0 0 2 2 1 
1 6 1 0 2 0 0 5 0 2 0 0 1 
1 0 0 0 2 0 0 2 0 0 0 0 1 
1 0 0 0 0 0 0 0 0 0 6 0 1 
1 4 0 1 0 1 0 0 0 1 0 0 1 
1 2 0 0 1 2 0 0 0 0 0 1 1 
1 2 0 0 0 0 0 1 0 0 0 0 1 
1 0 2 2 0 0 0 0 0 1 0 0 1 
1 0 0 0 0 0 0 0 0 0 0 0 1 
1 0 0 1 0 0 0 1 0 0 0 0 1 
1 1 1 1 1 1 1 1 1 1 1 1 1 
1 true 5 11 2 1 5 0
 9999