1 1 1 1 1 1 1 1 1 1 1 1 1 
1 0 0 0 0 0 0 0 0 0 0 0 1 
1 0 0 0 0 0 4 0 2 0 0 0 1 
1 0 0 2 0 0 0 0 2 0 1 1 1 
1 0 2 0 0 0 0 0 0 0 0 0 1 
1 0 0 2 0 0 0 1 1 0 0 4 1 
1 0 0 2 1 0 0 0 7 0 0 0 1 
1 0 2 0 0 0 0 0 0 0 0 1 1 
1 0 0 0 4 0 0 0 2 0 2 0 1 
1 0 0 0 0 4 1 0 0 0 0 0 1 
1 0 1 0 2 0 2 0 0 0 0 0 1 
1 1 0 0 0 0 0 0 2 0 0 0 1 
1 0 0 0 2 0 0 0 0 1 0 0 1 
1 4 0 0 2 2 0 0 0 0 0 0 1 
1 1 1 1 1 1 1 1 1 1 1 1 1 
1 true 2 5 2 1 5 0
4 true 4 5 3
4 true 6 5 3
4 true 7 5 3
4 true 8 7 3
4 true 10 5 3
4 true 10 8 3
4 true 10 10 3
4 true 11 10 3
 9999