1 1 1 1 1 1 1 1 1 1 1 1 1 
1 0 0 0 0 0 0 0 0 0 1 2 1 
1 0 2 0 1 1 0 0 0 0 0 0 1 
1 0 0 1 0 0 0 0 0 0 0 0 1 
1 0 2 0 0 4 0 0 0 0 0 0 1 
1 0 0 0 0 7 0 0 0 0 2 0 1 
1 0 2 0 0 0 0 0 0 0 0 0 1 
1 0 0 0 0 2 0 0 0 0 0 0 1 
1 0 0 2 0 1 4 0 0 0 0 0 1 
1 0 0 2 0 0 2 0 0 0 0 0 1 
1 0 0 0 0 0 0 0 0 0 1 0 1 
1 2 0 0 0 2 2 0 1 4 1 0 1 
1 0 0 2 4 0 0 0 0 0 0 0 1 
1 0 0 0 0 2 0 1 4 0 0 1 1 
1 1 1 1 1 1 1 1 1 1 1 1 1 
1 true 8 1 2 1 5 0
 9999