1 1 1 1 1 1 1 1 1 1 1 1 1 
1 0 1 1 0 0 2 0 0 1 2 0 1 
1 0 1 0 0 0 0 0 0 2 0 0 1 
1 0 1 0 0 0 0 0 0 0 2 0 1 
1 1 1 0 0 7 0 0 0 0 1 0 1 
1 0 2 0 0 0 0 0 2 0 0 2 1 
1 0 0 0 0 2 0 0 2 0 2 0 1 
1 0 0 0 0 0 0 0 0 0 0 1 1 
1 0 0 0 0 0 0 0 0 0 0 0 1 
1 0 0 2 0 0 0 2 0 1 0 0 1 
1 0 0 0 2 0 2 0 0 0 0 0 1 
1 0 0 0 1 0 0 0 1 1 0 6 1 
1 2 6 0 0 0 6 0 0 0 0 0 1 
1 0 5 0 0 0 0 5 0 0 1 0 1 
1 1 1 1 1 1 1 1 1 1 1 1 1 
4 true 1 1 3
1 true 6 2 2 1 5 0
 9999