1 1 1 1 1 1 1 1 1 1 1 1 1 
1 0 0 0 0 2 0 0 0 0 0 0 1 
1 0 0 0 2 0 0 0 0 0 1 0 1 
1 0 2 1 0 0 0 1 0 7 0 0 1 
1 0 1 0 0 2 0 0 0 0 0 0 1 
1 0 5 0 0 6 0 0 2 2 0 0 1 
1 0 0 0 2 0 0 0 0 0 0 0 1 
1 0 0 0 0 0 0 0 1 0 0 0 1 
1 0 0 0 0 0 1 0 2 0 2 1 1 
1 0 6 0 0 2 0 0 0 0 0 0 1 
1 0 4 0 0 0 1 0 0 2 1 0 1 
1 0 0 2 0 0 2 0 0 0 0 0 1 
1 0 0 0 5 0 0 0 0 0 0 0 1 
1 0 1 0 2 0 0 0 0 0 2 0 1 
1 1 1 1 1 1 1 1 1 1 1 1 1 
2 true 2 6 3 2 6 3 6 4 6 5 6 6 6 6 7 1010
3 true 7 4 3 5 false
 7 4 7 3 7 2 8 2 8 1 9 1 10 1 1010
1 true 11 10 2 1 5 0
 9999