1 1 1 1 1 1 1 1 1 1 1 1 1 
1 0 2 2 1 0 0 0 0 1 0 0 1 
1 2 0 0 0 0 0 0 0 0 0 0 1 
1 0 0 0 0 0 7 0 0 0 0 0 1 
1 0 0 0 0 0 0 0 0 0 0 2 1 
1 0 4 0 0 0 1 0 0 2 2 0 1 
1 0 0 0 5 0 0 0 0 0 0 0 1 
1 0 0 0 0 0 0 2 0 0 0 0 1 
1 0 0 0 0 0 0 0 0 0 1 0 1 
1 0 0 0 0 0 0 1 2 0 1 0 1 
1 0 0 0 0 1 0 1 0 0 0 0 1 
1 2 2 2 0 0 5 6 0 5 0 0 1 
1 0 0 0 2 0 0 1 0 0 0 0 1 
1 2 2 0 0 0 0 0 0 2 1 0 1 
1 1 1 1 1 1 1 1 1 1 1 1 1 
4 true 2 7 3
4 true 2 9 3
1 true 10 8 2 1 5 0
 9999