1 1 1 1 1 1 1 1 1 1 1 1 1 
1 0 1 0 1 0 1 0 1 0 0 0 1 
1 0 1 0 1 0 1 0 1 2 0 0 1 
1 1 1 1 1 1 1 1 1 2 0 0 1 
1 0 3 0 0 0 0 0 2 2 2 0 1 
1 1 0 0 1 2 0 1 0 0 5 0 1 
1 0 0 0 0 0 0 1 0 2 0 7 1 
1 0 0 0 0 0 0 0 0 0 1 0 1 
1 0 0 0 0 0 0 0 0 0 0 0 1 
1 2 0 0 5 0 0 0 6 2 0 2 1 
1 0 0 0 5 0 0 0 0 0 0 0 1 
1 2 0 0 0 0 0 0 0 0 0 0 1 
1 0 0 0 0 0 0 0 0 0 0 0 1 
1 0 0 0 0 0 0 0 0 0 2 1 1 
1 1 1 1 1 1 1 1 1 1 1 1 1 
5 true 1 1 3 5 false
3 true 1 3 3 4 false
 1 3 2 3 1010
2 true 1 5 3 1 5 2 5 1010
4 true 1 7 3
1 true 8 5 2 1 5 0
 9999