1 1 1 1 1 1 1 1 1 1 1 1 1 
1 0 5 0 0 0 0 0 2 0 1 0 1 
1 0 0 0 2 1 2 0 0 0 0 0 1 
1 2 0 0 0 0 1 3 2 0 0 0 1 
1 0 0 0 0 0 2 0 1 0 0 0 1 
1 0 0 0 0 0 0 2 0 0 0 0 1 
1 0 0 0 1 0 0 0 0 0 0 1 1 
1 0 2 0 0 0 0 0 1 0 0 0 1 
1 0 1 0 0 0 0 6 0 0 1 0 1 
1 0 2 0 0 3 0 0 0 0 0 0 1 
1 0 0 0 0 0 0 0 0 0 0 0 1 
1 0 0 0 0 0 0 2 0 0 0 2 1 
1 0 0 0 1 0 0 0 0 0 0 0 1 
1 0 0 0 2 2 2 7 0 5 2 0 1 
1 1 1 1 1 1 1 1 1 1 1 1 1 
1 true 2 9 2 1 5 0
 9999