1 1 1 1 1 1 1 1 1 1 1 1 1 
1 0 0 0 0 0 0 0 0 2 0 2 1 
1 0 1 2 0 2 0 0 0 0 0 0 1 
1 0 2 1 0 1 0 0 0 0 0 0 1 
1 2 2 0 0 0 0 0 0 0 0 0 1 
1 0 6 0 0 0 0 2 0 0 0 4 1 
1 0 0 2 0 0 0 0 0 0 0 0 1 
1 2 0 1 0 0 0 0 0 2 0 0 1 
1 0 2 0 0 6 0 0 0 1 0 0 1 
1 0 0 0 1 0 0 0 0 0 7 0 1 
1 0 0 0 0 0 2 0 0 0 0 0 1 
1 0 1 0 0 0 0 0 0 0 0 1 1 
1 2 0 0 0 0 0 0 2 0 0 4 1 
1 0 0 0 0 0 0 0 0 0 0 1 1 
1 1 1 1 1 1 1 1 1 1 1 1 1 
2 true 1 8 3 1 8 2 8 3 8 4 8 5 8 6 8 7 8 8 8 9 8 10 8 11 8 1010
1 true 4 10 2 1 5 0
 9999