1 1 1 1 1 1 1 1 1 1 1 1 1 
1 0 0 4 0 0 2 0 0 2 0 0 1 
1 0 1 0 1 0 1 2 1 0 1 0 1 
1 2 0 0 0 0 0 0 0 2 0 4 1 
1 0 1 2 1 0 1 0 1 0 1 2 1 
1 0 0 0 0 0 0 0 2 0 0 0 1 
1 4 1 0 1 0 1 2 1 0 1 0 1 
1 0 0 2 0 0 2 0 0 0 2 2 1 
1 0 1 0 1 0 1 0 1 0 1 0 1 
1 2 2 0 0 0 0 0 0 0 0 0 1 
1 0 1 0 1 6 1 0 1 0 1 2 1 
1 2 0 0 6 0 0 0 0 2 2 2 1 
1 0 1 0 1 0 1 0 1 0 1 0 1 
1 0 0 2 0 0 2 0 0 2 0 0 1 
1 1 1 1 1 1 1 1 1 1 1 1 1 
1 true 3 5 2 1 5 0
1 true 3 7 2 1 5 2
1 true 5 5 2 1 5 3
1 true 5 7 2 1 5 1
 9999