1 1 1 1 1 1 1 1 1 1 1 1 1 
1 0 0 6 2 0 0 2 0 3 0 0 1 
1 0 1 0 1 2 1 0 1 0 1 0 1 
1 2 0 0 0 0 0 2 2 5 0 2 1 
1 0 1 0 1 0 1 0 1 2 1 0 1 
1 0 0 0 0 0 0 0 0 2 0 0 1 
1 2 1 0 1 2 1 0 1 2 1 0 1 
1 0 0 0 0 2 0 0 2 0 0 0 1 
1 0 1 0 1 2 1 0 1 0 1 0 1 
1 0 0 3 0 0 2 0 2 0 0 0 1 
1 0 1 0 1 2 1 0 1 0 1 0 1 
1 3 0 0 2 0 0 0 0 0 0 2 1 
1 0 1 0 1 0 1 0 1 0 1 0 1 
1 0 0 2 0 2 0 0 0 2 0 0 1 
1 1 1 1 1 1 1 1 1 1 1 1 1 
1 true 1 1 2 1 5 0
1 true 1 11 2 1 5 1
1 true 13 1 2 1 5 2
1 true 13 11 2 1 5 3
 9999